Genes	MitoPathways_Hierarchy
EFHD1	Signaling_Calcium_homeostasis
 LETM1	Signaling_Calcium_homeostasis
 MCU	Signaling_Calcium_homeostasis
 MCUB	Signaling_Calcium_homeostasis
 MICU1	Signaling_Calcium_homeostasis
 MICU2	Signaling_Calcium_homeostasis
 MICU3	Signaling_Calcium_homeostasis
 PPIF	Signaling_Calcium_homeostasis
 RHOT1	Signaling_Calcium_homeostasis
 RHOT2	Signaling_Calcium_homeostasis
 SLC25A12	Signaling_Calcium_homeostasis
 SLC25A13	Signaling_Calcium_homeostasis
 SLC25A23	Signaling_Calcium_homeostasis
 SLC25A24	Signaling_Calcium_homeostasis
 SLC25A25	Signaling_Calcium_homeostasis
 SLC25A3	Signaling_Calcium_homeostasis
 SLC25A31	Signaling_Calcium_homeostasis
 SLC25A4	Signaling_Calcium_homeostasis
 SLC25A5	Signaling_Calcium_homeostasis
 SLC25A6	Signaling_Calcium_homeostasis
 SLC8B1	Signaling_Calcium_homeostasis
 SMDT1	Signaling_Calcium_homeostasis
 VDAC1	Signaling_Calcium_homeostasis
 VDAC3	Signaling_Calcium_homeostasis
LETM1	Signaling_Calcium_homeostasis_Calcium_cycle
 MCU	Signaling_Calcium_homeostasis_Calcium_cycle
 MCUB	Signaling_Calcium_homeostasis_Calcium_cycle
 MICU1	Signaling_Calcium_homeostasis_Calcium_cycle
 MICU2	Signaling_Calcium_homeostasis_Calcium_cycle
 MICU3	Signaling_Calcium_homeostasis_Calcium_cycle
 SLC25A3	Signaling_Calcium_homeostasis_Calcium_cycle
 SLC8B1	Signaling_Calcium_homeostasis_Calcium_cycle
 SMDT1	Signaling_Calcium_homeostasis_Calcium_cycle
PPIF	Signaling_Calcium_homeostasis_Mitochondrial_permeability_transition_pore
 SLC25A31	Signaling_Calcium_homeostasis_Mitochondrial_permeability_transition_pore
 SLC25A4	Signaling_Calcium_homeostasis_Mitochondrial_permeability_transition_pore
 SLC25A5	Signaling_Calcium_homeostasis_Mitochondrial_permeability_transition_pore
 SLC25A6	Signaling_Calcium_homeostasis_Mitochondrial_permeability_transition_pore
 VDAC1	Signaling_Calcium_homeostasis_Mitochondrial_permeability_transition_pore
 VDAC3	Signaling_Calcium_homeostasis_Mitochondrial_permeability_transition_pore
EFHD1	Signaling_Calcium_homeostasis_EF_hand_proteins
 MICU1	Signaling_Calcium_homeostasis_EF_hand_proteins
 MICU2	Signaling_Calcium_homeostasis_EF_hand_proteins
 MICU3	Signaling_Calcium_homeostasis_EF_hand_proteins
 RHOT1	Signaling_Calcium_homeostasis_EF_hand_proteins
 RHOT2	Signaling_Calcium_homeostasis_EF_hand_proteins
 SLC25A12	Signaling_Calcium_homeostasis_EF_hand_proteins
 SLC25A13	Signaling_Calcium_homeostasis_EF_hand_proteins
 SLC25A23	Signaling_Calcium_homeostasis_EF_hand_proteins
 SLC25A24	Signaling_Calcium_homeostasis_EF_hand_proteins
 SLC25A25	Signaling_Calcium_homeostasis_EF_hand_proteins
ACOD1	Signaling_Immune_response
 C1QBP	Signaling_Immune_response
 IFI27	Signaling_Immune_response
 MAVS	Signaling_Immune_response
 NLRX1	Signaling_Immune_response
ADCY10	Signaling_cAMP_PKA_signaling
 AKAP1	Signaling_cAMP_PKA_signaling
 AKAP10	Signaling_cAMP_PKA_signaling
 PDE2A	Signaling_cAMP_PKA_signaling
 PRKACA	Signaling_cAMP_PKA_signaling
 SPHKAP	Signaling_cAMP_PKA_signaling
AHCYL1	Mitochondrial_dynamics_and_surveillance
 AIFM1	Mitochondrial_dynamics_and_surveillance
 AIFM2	Mitochondrial_dynamics_and_surveillance
 AIFM3	Mitochondrial_dynamics_and_surveillance
 APOO	Mitochondrial_dynamics_and_surveillance
 APOOL	Mitochondrial_dynamics_and_surveillance
 ARL2	Mitochondrial_dynamics_and_surveillance
 ARMC10	Mitochondrial_dynamics_and_surveillance
 ARMCX1	Mitochondrial_dynamics_and_surveillance
 ARMCX3	Mitochondrial_dynamics_and_surveillance
 ATAD3A	Mitochondrial_dynamics_and_surveillance
 ATAD3B	Mitochondrial_dynamics_and_surveillance
 ATP5MD	Mitochondrial_dynamics_and_surveillance
 ATP5ME	Mitochondrial_dynamics_and_surveillance
 ATP5MG	Mitochondrial_dynamics_and_surveillance
 BAD	Mitochondrial_dynamics_and_surveillance
 BAK1	Mitochondrial_dynamics_and_surveillance
 BAX	Mitochondrial_dynamics_and_surveillance
 BBC3	Mitochondrial_dynamics_and_surveillance
 BCL2	Mitochondrial_dynamics_and_surveillance
 BCL2A1	Mitochondrial_dynamics_and_surveillance
 BCL2L1	Mitochondrial_dynamics_and_surveillance
 BCL2L10	Mitochondrial_dynamics_and_surveillance
 BCL2L11	Mitochondrial_dynamics_and_surveillance
 BCL2L13	Mitochondrial_dynamics_and_surveillance
 BCL2L2	Mitochondrial_dynamics_and_surveillance
 BID	Mitochondrial_dynamics_and_surveillance
 BIK	Mitochondrial_dynamics_and_surveillance
 BNIP3	Mitochondrial_dynamics_and_surveillance
 BNIP3L	Mitochondrial_dynamics_and_surveillance
 BOK	Mitochondrial_dynamics_and_surveillance
 CASP3	Mitochondrial_dynamics_and_surveillance
 CASP8	Mitochondrial_dynamics_and_surveillance
 CASP9	Mitochondrial_dynamics_and_surveillance
 CHCHD2	Mitochondrial_dynamics_and_surveillance
 CHCHD3	Mitochondrial_dynamics_and_surveillance
 CHCHD6	Mitochondrial_dynamics_and_surveillance
 CYCS	Mitochondrial_dynamics_and_surveillance
 DIABLO	Mitochondrial_dynamics_and_surveillance
 DNAJC11	Mitochondrial_dynamics_and_surveillance
 DNM1L	Mitochondrial_dynamics_and_surveillance
 ENDOG	Mitochondrial_dynamics_and_surveillance
 FIS1	Mitochondrial_dynamics_and_surveillance
 FKBP8	Mitochondrial_dynamics_and_surveillance
 FUNDC1	Mitochondrial_dynamics_and_surveillance
 FUNDC2	Mitochondrial_dynamics_and_surveillance
 GHITM	Mitochondrial_dynamics_and_surveillance
 HTRA2	Mitochondrial_dynamics_and_surveillance
 IFI27	Mitochondrial_dynamics_and_surveillance
 IMMT	Mitochondrial_dynamics_and_surveillance
 MARCHF5	Mitochondrial_dynamics_and_surveillance
 MCL1	Mitochondrial_dynamics_and_surveillance
 MFF	Mitochondrial_dynamics_and_surveillance
 MFN1	Mitochondrial_dynamics_and_surveillance
 MFN2	Mitochondrial_dynamics_and_surveillance
 MGARP	Mitochondrial_dynamics_and_surveillance
 MICOS10	Mitochondrial_dynamics_and_surveillance
 MICOS13	Mitochondrial_dynamics_and_surveillance
 MIEF1	Mitochondrial_dynamics_and_surveillance
 MIEF2	Mitochondrial_dynamics_and_surveillance
 MIGA1	Mitochondrial_dynamics_and_surveillance
 MIGA2	Mitochondrial_dynamics_and_surveillance
 MTCH2	Mitochondrial_dynamics_and_surveillance
 MTFP1	Mitochondrial_dynamics_and_surveillance
 MTFR1	Mitochondrial_dynamics_and_surveillance
 MTFR2	Mitochondrial_dynamics_and_surveillance
 MTX1	Mitochondrial_dynamics_and_surveillance
 MTX2	Mitochondrial_dynamics_and_surveillance
 MTX3	Mitochondrial_dynamics_and_surveillance
 MUL1	Mitochondrial_dynamics_and_surveillance
 MYO19	Mitochondrial_dynamics_and_surveillance
 NBR1	Mitochondrial_dynamics_and_surveillance
 NIPSNAP1	Mitochondrial_dynamics_and_surveillance
 NIPSNAP2	Mitochondrial_dynamics_and_surveillance
 OMA1	Mitochondrial_dynamics_and_surveillance
 OPA1	Mitochondrial_dynamics_and_surveillance
 PARK7	Mitochondrial_dynamics_and_surveillance
 PARL	Mitochondrial_dynamics_and_surveillance
 PGAM5	Mitochondrial_dynamics_and_surveillance
 PIGBOS1	Mitochondrial_dynamics_and_surveillance
 PINK1	Mitochondrial_dynamics_and_surveillance
 PLD6	Mitochondrial_dynamics_and_surveillance
 PMAIP1	Mitochondrial_dynamics_and_surveillance
 PRKN	Mitochondrial_dynamics_and_surveillance
 RAB24	Mitochondrial_dynamics_and_surveillance
 RHOT1	Mitochondrial_dynamics_and_surveillance
 RHOT2	Mitochondrial_dynamics_and_surveillance
 RMDN3	Mitochondrial_dynamics_and_surveillance
 RTL10	Mitochondrial_dynamics_and_surveillance
 SAMM50	Mitochondrial_dynamics_and_surveillance
 SEPTIN4	Mitochondrial_dynamics_and_surveillance
 SLC25A46	Mitochondrial_dynamics_and_surveillance
 SNAP29	Mitochondrial_dynamics_and_surveillance
 SPHK2	Mitochondrial_dynamics_and_surveillance
 SPIRE1	Mitochondrial_dynamics_and_surveillance
 STX17	Mitochondrial_dynamics_and_surveillance
 STYXL1	Mitochondrial_dynamics_and_surveillance
 SYNJ2BP	Mitochondrial_dynamics_and_surveillance
 TMEM11	Mitochondrial_dynamics_and_surveillance
 TOMM20	Mitochondrial_dynamics_and_surveillance
 TOMM7	Mitochondrial_dynamics_and_surveillance
 USP30	Mitochondrial_dynamics_and_surveillance
 VDAC1	Mitochondrial_dynamics_and_surveillance
 VPS13D	Mitochondrial_dynamics_and_surveillance
